11111111111111111111111111111111
CCCCCCCCCCCCC11CCCCCCCCFCCCC11CC
1C1111C11111C11C11111C11111C11C1
1M1111C11111C11C11111C11111C11M1
1C1111C11111C11C11111C11111C11C1
CCCCCCCCCCCCCCCCCCCCCCCCCCCCCCCC
1C1111C11C111111111111C11C1111C1
1C1111C11C111111111111C11C1111C1
1CCCCCC11CCCC11CCCCCCCCCCCCCCCC1
111111C11111C11C1111C11C11111C11
111111C11111C11C1111C11C11111C11
111111C11111C11C1111C11C11111C11
1CCCCCCCCCCCCCCPCCCCCCCCCCCCCCC1
1C1111C11C111111111111C11C1111C1
1C1111C11C111111111111C11C1111C1
CCCCCCC11CCCC11CCCCCCCCCCCCCCCCC
1C1111C11111C11C1111C1111C1111C1
1C1111C11111C11C1111CC111C1111C1
1C1111CCCFCCC11C11111C111CCC11C1
1M1111C11111C11C11111C11111CCCM1
1C1111C11111C11C11111C11111C11C1
CCCCCCCCCCCCC11CCCCCCCCCCCCC11CC
11111111111111111111111111111111
11111111111111111111111111111111