11111111111111111111111111111111
............C11C...........C11..
1.1111.11111.11.11111.11111.11.1
1M1111.11111.11.11111.11111.11M1
1.1111.11111.11.11111.11111.11.1
................................
1.1111.11.111111111111.11.1111.1
1.1111.11.111111111111.11.1111.1
1C.....11C...11C..............C1
111111.11111.11.1111.11.11111.11
111111.11111.11.1111.11.11111.11
111111.11111.11.1111.11.11111.11
1..............Pp..............1
1.1111.11.111111111111.11.1111.1
1.1111.11.111111111111.11.1111.1
.......11....11C................
1.1111.11111.11.1111.1111.1111.1
1C1111.11111.11.1111..111.1111C1
1.1111.......11.11111.111...11.1
1M1111.11111.11.11111.11111...M1
1.1111.11111.11.11111.11111.11.1
......C......11C............11..
11111111111111111111111111111111
11111111111111111111111111111111