11111111111111111111111111111111
.............11........F....11..
1.1111.11111.11.11111.11111.11.1
1M1111.11111.11.11111.11111.11M1
1.1111.11111.11.11111.11111.11.1
................................
1.1111.11.111111111111.11.1111.1
1.1111.11.111111111111.11.1111.1
1......11....11................1
111111.11111.11.1111.11.11111.11
111111.11111.11.1111.11.11111.11
111111.11111.11.1111.11.11111.11
1.............CPpC.............1
1.1111.11.111111111111.11.1111.1
1.1111.11.111111111111.11.1111.1
.......11....11.................
1.1111.11111.11.1111.1111.1111.1
1.1111.11111.11.1111..111.1111.1
1.1111...F...11.11111.111...11.1
1M1111.11111.11.11111.11111...M1
1.1111.11111.11.11111.11111.11.1
.............11.............11..
11111111111111111111111111111111
11111111111111111111111111111111