11111111111111111111111111111111
1............11.............1..1
1.1111.11111.11.11111.11111.1..1
1.1111.11111.11.11111.11111.1..1
1..............................1
1.1111.11.111111111111.11.1111.1
1.1111.11.111111111111.11.1111.1
1......11....11....11....11....1
111111.11111.11.1111.11.11111.11
111111.11111.11.1111.11.11111.11
1............11111111..........1
1............11....11..........1
1....M.........Pp...........M..1
1............11....11..........1
1............11111111..........1
111111.11111.11.1111.11.11111.11
111111.11111.11.1111.11.11111.11
.......11....11....11....11.....
1.1111.11.111111111111.11.1111.1
1.1111.11.111111111111.11.1111.1
1..............................1
1.1111.11111.11.11111.11111.1..1
.............11.............1...
11111111111111111111111111111111